####################################################################################################
#*#*********#*#*#*******#*********#*#***********#*#*#*#*******#***************#*****************#*#*
#*###*#*###*#*#*#*#########*#*###*#*###*#*#*###*#*#*#*#*###*###*###*#*#*#*#*###########*###*#*###*#*
#*****#*#***********#*#*****#*#*********#*#*#*************#*******#*#*#*#*#***#*#*#*#*****#*#*******
#*#*#*#####*###*#####*###*#####################*#####*###*#################*###*#*#*###*#####*#*#*#*
#*#*#*****#*#*#***#*******#*#*#*#*#*#*#*#*#*#***#*#*#***#*#*#*#*#*#*****#*************#***#*#*#*#*#*
#*###########*#*#####*#*###*#*#*#*#*#*#*#*#*#####*#*#*#####*#*#*#*#####*###*#*#*#*#*###*###*#######*
#***#*#*#*#*#***#*****#*#*#*******************#*********#*********#*#*#***#*#*#*#*#*******#*****#***
#*###*#*#*#*#*#####*#*###*#*###*#*#*#*#*#*#*#####*###*#*###*#*###*#*#*###*#########*#*#*###*###*###*
#*#*************#***#*#*#*****#*#*#*#*#*#*#*****#***#*#*#***#*#*********#*#*******#*#*#*#***#*******
#*###*###*#########*###*#*###########*#######*###*#####*###*#####*###*###*###*###*#######*#*###*#*#*
#*#*****#*#*#*#*****#*#*****#*********#*#*#*#*******#***#*******#*#*#***#*#***#***#*******#*#*#*#*#*
#*###*#####*#*###*###*#*#######*#######*#*#*###*#*###*#*###*#*#####*#*###*###*###*###*#*#*###*######
#*#***#*#*********#*******#*****#*#*#*********#*#*#***#*#*#*#***#*******#*#***#***#***#*#*#*********
#*###*#*###*#*#*#*###*###########*#*###*###*#######*#*###*###*#*###*#####*###*###*###*#####*###*#*##
#*#*****#***#*#*#*#*****#*#*#*#*********#*****#*****#*#***#*#*#*#***#*#*#*****#***#***********#*#***
#*#####*###*#########*###*#*#*###*#*#######*###*#*#*#####*#*###*###*#*#*###*#*###*###*###########*#*
#***#*#*#*********#***#*******#***#*#*#*#*#***#*#*#*#*#*#***#***#*********#*#*#*********#*#*#*#***#*
#*###*#*###*#*#*#*###*###*###*###*###*#*#*#*###*#####*#*###*###*###*###*###########*#####*#*#*#####*
#*#*******#*#*#*#*#***#***#*******#*#*********#***********#*#*****#*#*****#*#*#*#*#*#*#*********#***
#*###*###*#######*###*###*###*#*###*#*#################*###*###*#######*###*#*#*#*###*###*###*#####*
#*#*#***#***#*#***#*********#*#*#*#*****#*#*#*#*#*#*#*#*****#*******#***#*********#*******#*#***#***
###*#*###*###*###*###*#*#*#######*#*#####*#*#*#*#*#*#*###*#####*#*#####*###*#*###*###*#*###*#*#####*
#*#*****#*#*********#*#*#*#*#*#*#*****#***************#*#*****#*#***#*******#*#***#***#*#*******#***
#*#*#########*#*#*#########*#*#*#*#######*#*#*#*#*###*#*#####*###*#*#########*###*###*#####*#####*#*
#***#*#*#*#***#*#*#*****#***********#*#***#*#*#*#*#*****#*#*#***#*#***#*#*#*#*#*******#*#*#***#***#*
#*###*#*#*###*#####*###*###*###*#####*###*#############*#*#*#######*###*#*#*#####*#*###*#*#*###*#*##
#*#*******#***********#*#*****#*#*#***********#*#*#*#*#*****#*#*****#*********#***#*#*********#*#*#*
#*###*###*###*#*#*#*###*###*#####*###*#*#*#*###*#*#*#*#####*#*###*#####*###*#######*###*###*###*###*
#*#***#***#*#*#*#*#*#***#***#*#*******#*#*#*#***********#*********#*#*#***#***#*#*#*#*#***#*#*****#*
#*###*###*#*###########*###*#*###*#*#*#########*###*#*#####*#*#*###*#*#*###*###*#*###*#*#####*#*###*
#*#***#*************#***#*****#***#*#*#***#*#*#***#*#***#***#*#*#*********#*********#*****#***#*#***
#*###*###*#*###*#######*#####*###*#####*###*#*#*#####*#####*#######*###*###*#*#*#*###*#######*###*##
#*******#*#*#***#*#*******#***#*********#*********#*****#*******#*#***#*#***#*#*#***#***#*******#*#*
#*#######*#####*#*###*#*#####*###*#########*###*###*#*###########*#*#############*###*#####*#*###*#*
#*#*#*#*#***#*****#***#*#*#*********#*#*#*#***#*#***#*#***#*#*#*****#*#*#*#***#*********#***#*#*#***
###*#*#*#####*###*###*###*###*#*#*###*#*#*#*#######*#####*#*#*###*###*#*#*###*###*#*#*#####*###*###*
#*#*******#*#*#*********#***#*#*#*#***********#*******#*********#*#*********#***#*#*#*#*#*********#*
#*#*###*###*###*#*#*#*###*###########*###*#*###*#*#*#####*###*###*###*###*#####*#######*###*#*#*###*
#*****#*******#*#*#*#*#***#*#*#*#*#*#***#*#*#***#*#*#*#*#***#***#*****#*#***#*******#*#*#*#*#*#*****
#*#####*#*#*###*#######*###*#*#*#*#*#*#########*#####*#*#*###*###*#*###*#*###*###*###*#*#*#####*#*#*
#***#***#*#***#*********#*#*************#*#*******#*********#***#*#*#*******#*#***#*******#*#*#*#*#*
#*#########*###*#*#*#*###*#*###*#*#*#*###*###*#*###*###*#*###*#########*#####*###*###*###*#*#*#####*
#*#*#*#*******#*#*#*#*#*******#*#*#*#*#*#*****#*#*#*#*#*#*#*******#*#*#***#***#*#*#***#*********#***
#*#*#*#####*#########*###*#############*###*#*###*#*#*#######*#*###*#*#*#######*#*###*#####*###*###*
#*******#*******#*****#*#***#*#*******#*****#*#*******#*#***#*#***#*******#*#*#***#*****#*****#*#***
#*###*#####*#*#####*###*#*###*###*###*###*#*#####*###*#*###*###*###*###*###*#*#*#####*#####*#######*
#*#*#***#*#*#***#***#*******#*#***#*******#*****#*#*****#*#***********#*#*#*****#*****#*#*#***#*****
###*#*###*###*###*#####*#####*###*###########*#####*###*#*#####*#*#*#####*#*#######*###*#*#*#####*#*
#*#*****#*#*****#*#*#*#***#***#*****#*#*#*#*#*****#*#*******#*#*#*#*#*#*****#*#*****#*#*******#***#*
#*#*#####*###*#####*#*#*###*#####*###*#*#*#*###*#########*###*#######*###*###*###*###*#*###*#####*##
#*****#***#*****#*#*******#*#*****#*#*********#***#*#*#***#*#***********#*#*******#*#*****#*#*#*****
#*#######*###*###*#*###*###*###*###*#*###*#*###*###*#*###*#*###*###*#*###*###*#*###*#*###*###*###*##
#*#*#*#***************#*#***#***#*******#*#***#*********#*****#*#*#*#***#*#***#*#*******#*#*********
#*#*#*###*#######*#*#####*#####*###*#######*###*#*#*#*#####*###*#*###*###*###*#####*#########*#*#*##
#*******#*#*#*#*#*#*#*****#*#***#***#*#*******#*#*#*#*****#***#*****#*****#*****#*****#*#*****#*#*#*
#####*#####*#*#*#######*###*###*###*#*#####*#########*#*###*#####*###*#*#*###*#####*###*###*#*#####*
#*#*#***#*******#*#*#***#*******#****A**#*****#*#*#*#*#*******#*#***#*#*#*#*****#***#*******#*#*****
#*#*#*#####*###*#*#*###*###*#*#*###*#*###*#*###*#*#*###*#*#*###*#*#######*###*#####*###*#*#*###*###*
#*****#*#***#*********#*****#*#*#*#*#*#***#*#*********#*#*#*#*******#*****#*****#*******#*#*#*#*#*#*
#*#####*###*#######*###*#*#*#####*#####*#*#####*#*###*#######*#########*#####*#*###*#*#*#####*#*#*##
#*#*#*********#*#*#***#*#*#*#*#*****#***#*#*#***#*#*#*******#*#*#*#*#***#*#*#*#***#*#*#*#***********
#*#*###*#*#*###*#*#*###*#####*#*#######*###*###*###*#*###*###*#*#*#*#####*#*###*#*#######*#*#####*##
#***#***#*#*#*********#*****#*****#*******#*****#*#*****#*#*********#*#*******#*#***#*#*#*#*#*#*#***
###*###*#######*###*###*#*###*#######*#*###*#*###*#*###*#####*#*###*#*###*###*###*###*#*#####*#*#*##
#*********#*#*****#*#*#*#*****#*#*****#*#***#*#*******#*#*****#*#*********#***#***********#*#*******
#*#*#*#*###*###*#####*###*#####*###*#*#####*#####*###*#####*#*#####*#*#*#*###*###*#*#*#*###*#*###*#*
#*#*#*#*****#*#***#*******#*#*******#*#*******#*****#*#*#***#*#***#*#*#*#*#*****#*#*#*#*********#*#*
#*###########*#*###########*###*#*#*###*#*#*#####*#####*###*#####*#############*#######*#*#*#*#####*
#*******#*#*#*****#*#*#*#*******#*#*#***#*#*#*#***#*#*********#*#***********#*********#*#*#*#*#*****
#*#*#*###*#*#*#####*#*#*###*#*#*#####*#*#####*###*#*###*#*#*###*#*###*#*#*#######*###*#########*#*#*
#*#*#*#*********#***********#*#*#*#*#*#*****#*#*****#***#*#*#*******#*#*#*****#*#***#*******#***#*#*
###*#####*###*#####*#*#*#*#*#####*#*###*#*###*#####*###*#####*###*#######*#####*#*###*#*#######*####
#***#*#*#***#*#*****#*#*#*#*#*********#*#***#***#*#*#*****#*****#*#***#*****#*******#*#***#*#*****#*
#####*#*#*###*###*#*#########*###*#*#####*###*###*#*###*#####*#####*#####*#####*#######*###*###*###*
#*#*#*******#*#***#*#***********#*#***#*******#*****#*****#*****#***#*#*****#***#*#*#*#*#*********#*
#*#*#*###*###*###*#######*###*#####*#####*#*#####*#####*#####*#####*#*###*#####*#*#*#*#####*#*#*###*
#*******#*#***#*******#***#*#***#*****#*#*#***#*#*#*******#*****#***********#***********#***#*#*#***
#*###*#*#########*#*#######*#*#####*###*###*###*#*###*#*#####*#############*###*#*###*#####*#####*##
#***#*#*#*#*#*#*#*#***#*#*#*****#*****#*****#*****#***#*#*******#*#*#*#*#*#***#*#*#***#*******#*#***
#*#######*#*#*#*###*###*#*#*#######*###########*#####*#######*###*#*#*#*#*###########*###*#*###*#*##
#*#*#*#*********#*************#*******#*#*#*#*#***#*******#***#*************#*#*#*#*******#*#*******
#*#*#*###*#####*###*#*#*#*#*###*#*#*###*#*#*#*#*#####*#*#####*###*#*#*###*###*#*#*###*#*#*###*######
#*********#*#*#***#*#*#*#*#*#***#*#*#*************#*#*#*****#*****#*#*#***#*********#*#*#*#*#*#*#*#*
###*#*#*###*#*#*#############*#*#####*#########*###*###*#*#####*#*#######*###*#####*#######*#*#*#*#*
#***#*#*#*********#*#*#***#***#*#*******#*#*#*#*******#*#*****#*#*#***#*******#*#*#*#*#***#*********
###*#######*###*###*#*#*#####*#####*#####*#*#*###########*#*###*###*#####*#*###*#*#*#*###*###*#####*
#*****#*#*#***#*********#*******#*#***#*******#*#*#*#***#*#***#*********#*#*#***********#*****#*#*#*
#*#*###*#*#*###*#*#*#*#####*#*###*#*#####*###*#*#*#*#*#####*#########*#########*###*#*###*#*###*#*#*
#*#*#*********#*#*#*#*#*****#*#*******#***#***********#*#*****#*#*#*#*******#*#***#*#***#*#*#*******
#*#####*###*#######*#####*#*###*#########*###*#*#*###*#*###*###*#*#*#########*#*#####*###*#####*###*
#***#*#***#*#*******#*#***#*#*#*#*#*#*#*****#*#*#*#*****#*************#*#*#*******#*****#*#*#*#***#*
#*###*#*#######*#*###*###*###*#*#*#*#*###*#*###########*###*#*#*#*#*###*#*###*#####*#*#####*#*#*###*
#*#*******#*****#*#*********#*********#*#*#***#***#*#*#***#*#*#*#*#*********#***#***#*#***********#*
#*###*###*#######*###*#*#*###*#*#*###*#*###*###*###*#*#*###########*#*#*#*###*#####*#######*###*###*
#*#*****#*#*#*#*#*#***#*#*#***#*#*#*****#*****#*#*******#*#*#*#*#*#*#*#*#***#***#*******#*****#*#***
#*###*#####*#*#*#####*#######*#########*###*###*###*#####*#*#*#*#*#######*###*#####*#*#####*#####*#*
#*#***#*#*******#*******#*******#*#*#***#*****#*#***#*#*************#*#*****#***#*#*#*****#***#***#*
#*###*#*###*###*###*#*#####*#*###*#*###*###*###*###*#*###*#*#*#*###*#*###*###*###*###*#*###*#####*##
#*#*********#*******#*#*****#*******#***********#*********#*#*#*#***************#*****#*******#*****
