*********#*********#*#***********************#*************#*******#*******#*******#***#*#*#*******#
##*###*#####*###*###*###*#*#*#*#######*###*#####*###*#*#*###*###*#####*###*#*###*###*###*#*#*###*#*#
*#***#*#*****#***#*******#*#*#*#*#*#*#***#***#*#***#*#*#*******#***#***#*****#*#*****#*******#*#*#*#
*#*#######*#*###*###*#*#*#######*#*#*#*###*###*#*#######*#*#*###*#*###*#####*#*###*#####*###*#*#####
***#*#*****#*#*******#*#*****#*#*********#*********#***#*#*#*#*#*#*#*****#*******#*#*****#*****#*#*#
*###*###*#*#####*#########*###*#*###*#*###*#*#*#*###*#########*###*###*#######*###*###*#*#####*#*#*#
*#*******#*#***#*#*#*#*#*#*#*#*****#*#*#***#*#*#*#***#*******#*****#*****#*#***#*#*#***#*#*#*******#
*###*#*#*#####*###*#*#*#*###*#*###*###############*#####*###*###*#*###*###*###*#*#####*###*###*###*#
*#***#*#*#*****#***********#*****#*#*#*#*#*********#*#***#***#***#*#*****#*#*****#*#*****#***#*#***#
*###*#########*###*###*#*###*#######*#*#*#####*#####*###*###*###*#####*###*#####*#*###*#####*#####*#
*#*****#***#*#*#***#*#*#***#***#*#*********#*#***#*******#*#*#*****#*********#*****#*******#***#***#
*###*#####*#*#*###*#*###*###*###*###*###*###*#*#####*#####*#*###*#####*#*#*#######*###*#*#####*###*#
*******#*#*****#*******#*****#*******#*****#***#*****#*#*#***#*******#*#*#*#*#*#*#***#*#***#***#***#
##*#*###*#*###*#####*###*#*#####*#*#*###*###*#####*###*#*#*#####*#*#*###*###*#*#*#*#####*#####*###*#
***#*#*******#***#*****#*#*#*****#*#*#*****#*#*#***#*******#*****#*#*#***#***********#*****#***#***#
*#*#####*#######*###*#########*#*#######*###*#*###*###*#######*#########*###*###*#######*#####*###*#
*#*#*****#*#*#*#*#***#*#*#*****#*#*#*#***#*#*******#***#*#*****#*#*#*****#***#*#***#*#*****#*#*#***#
*###*###*#*#*#*#####*#*#*###*#*###*#*###*#*#######*###*#*###*###*#*###*#*###*#*#####*###*###*#*###*#
***#*#*********#*#***********#*#*****#*****#*#*#*#*#*****#***#*********#*#*******#*********#***#***#
*###*###*#*###*#*###*#*#*#*#*###*###*#####*#*#*#*###*###*###*###*#*#*#*#######*#####*#*#*###*#####*#
***#***#*#*#*******#*#*#*#*#*#***#*****#*********#*#*#*******#***#*#*#*#*#*#***#*#***#*#*#***#*#*#*#
*###*#########*###*#############*#####*###*#*###*#*###*#*#*#####*#######*#*###*#*###*#####*###*#*#*#
***#*********#*#*******#*#*********#*****#*#*#*******#*#*#*#*******#*******#*****#*********#*#*****#
*###*#*#*#*###########*#*###*#*#*#######*#########*###*#######*#*#####*###*#####*###*#*#*###*#*###*#
***#*#*#*#*#*#*#*#*#*********#*#*#***#*********#***#*#*****#***#*#*****#*#***#*****#*#*#*#*******#*#
*#######*###*#*#*#*#####*#*#*#####*#####*#*###*###*#*###*#*###*#######*#*###*#####*#####*###*#####*#
***#*****#*#*********#***#*#*#*#*******#*#*#*#*#*******#*#*#*******#*******#***#*********#***#*#***#
*###*#*###*#*###*#*###*#*#####*#*###*#######*#*#####*#########*#*#######*###*#*###*#*#*#*###*#*###*#
***#*#*#*******#*#***#*#*#*********#*****#*******#*****#*#*#*#*#*****#*****#*#***#*#*#*#*#*****#*#*#
*###*#####*#######*###*###*###*#*###*#*#*###*###*###*###*#*#*###*#*#####*#####*#*#############*#*###
***#*#*#*#***#*#*****#*******#*#*#***#*#*#*****#*#***#*********#*#***#*#***#*#*#*****#*#*#*#*****#*#
*#####*#*#*###*###*###############*#########*###*###*###*#*###*###*###*#*###*###*#*###*#*#*#####*#*#
***#*********#*#*******#*#*#*******#*#*#*#*#***#*#*#*#***#*#*********#*****#***#*#***********#*****#
*#####*###*###*###*#*###*#*#####*###*#*#*#*#*#####*#*###*#####*#*#*###*#######*###*###########*###*#
***#*#***#*#*****#*#*********#*#*#***********#*#*#***#*******#*#*#*#*****#*********#*#*#*#*#*#*#*#*#
*###*#*#########*###*#*#*#*###*#####*###*#*###*#*#*#####*#*#*#######*#####*#########*#*#*#*#*###*#*#
***#*****#***#*#***#*#*#*#*******#***#*#*#*#*********#*#*#*#*****#***#*#***#*#*#*#*************#***#
*###*#######*#*#*#########*#*#*#####*#*###*###*###*###*#####*#*#####*#*#####*#*#*###*#######*###*###
***#***#***#*****#*******#*#*#*****#*****#*#***#*#*****#***#*#***#*#***#*#*******#***#*#*#*#*******#
*###*#####*#*###*###*###*#####*#*#####*###*###*#*###*#####*###*###*###*#*###*###*###*#*#*#*#####*###
***#***#*#*****#*#***#***#***#*#***#*****#*#*******#***#*#*#*********#***#***#***#*********#*#*#***#
*###*###*#*#########*###*#*#####*#####*###*#####*###*###*#*###*#*#*#####*###*###*###*#*###*#*#*###*#
*******#***#*#*#*#***#*****#*******#*****#***#*#***#*********#*#*#*****#*#***#***#*#*#*#*********#*#
*#*#*###*###*#*#*###*###*#####*#*#####*###*###*#*###*#############*#*###*###*###*#*#######*###*###*#
*#*#*#*#*#***********#*#***#***#*#*#*#***#*#*#*****#***#*#*#*****#*#***#*#***#*******#*#*#*#***#*#*#
######*#*###*#*#*#*###*#*#####*###*#*#*#####*#*#########*#*#*#######*###*###*#######*#*#*#####*#*###
***#*********#*#*#*#*#*****#*****#*******#*****#*#*#*#*******#*#*******#*****#*#*#*#*******#*****#*#
##*###*#*#*#*#######*#*###*###*###*###*#####*###*#*#*###*###*#*###*#*###*#*###*#*#*#*###*#*#####*#*#
***#***#*#*#*#*#*#*******#*#*********#***#***#*******#***#*********#*#***#*#*#*********#*#***#*****#
##*###*#######*#*###*#####*###*#*#*#########*###*###*###*###*#*#*#*#####*###*#*###*#*#####*#*#####*#
***#*********#***#***#*#*****#*#*#***#*#*#*#*#***#*********#*#*#*#*#*****#*#*****#*#*#***#*#***#***#
##*###*#*#*#####*###*#*###*#######*###*#*#*#*###*###*#*#*#################*#*###########*###*#*###*#
*#*#*#*#*#***#***#*******#*#*******#*#*******#*****#*#*#*#***********#*#*#*****#*******#***#*#*#***#
*#*#*#####*#####*#####*#######*#*###*#*###*#*###*###################*#*#*#*#####*###*###*#####*###*#
*******#*******#***#*****#*#***#*#*#*****#*#*#*************#*#*#*#*#*********#*#***#*******#***#***#
*###*#####*#*#####*###*###*###*###*#*#######*###*#*#*#*#*###*#*#*#*#*###*#*###*#*###*#*#*#####*###*#
***#*#*#*#*#***#*#*#***#*******#*#*****#*******#*#*#*#*#*************#*#*#*#*#*****#*#*#*#*****#*#*#
*#####*#*###*###*#*###*###*#*###*#*#########*###########*#*#*#*#*#*###*#####*#*###*#########*###*#*#
*#*#***************#*******#*#*#***#*#*#*#*****#*******#*#*#*#*#*#*#**A**#*******#*#*#*#*****#*#***#
*#*###*#######*#*#############*#*###*#*#*###*###*###*#*###########*###*#######*#####*#*###*###*#*###
*******#*#*#*#*#***#*#*#*#*#*#***#*********#***#***#*#***#*#*#*#***#*******#***#*#*********#*#*****#
########*#*#*###*###*#*#*#*#*#*#####*###*###*###*#####*###*#*#*###*###*#*#####*#*###*#*#*###*#*#####
*#*#*#*#*******#*#*#***********#*****#*#***#*******#***********#*****#*#***#*********#*#*#*******#*#
*#*#*#*#*###*#####*#*###*#*#*#####*###*#*###*#*#*#########*#*#*###*#####*#####*#*#*#*#######*#####*#
***********#*****#*****#*#*#*#*****#*#*****#*#*#***#*#*#*#*#*#*#*****#*****#***#*#*#*#***#***#*#***#
*###*#*#*###*#*###*#########*###*###*#*#########*###*#*#*#########*#####*###*#*#########*###*#*###*#
***#*#*#*#*#*#*******#*#*#***#***#*******#*******#*********#*#*#*****#*****#*#*******#*#*#*******#*#
*#########*###*#*#*###*#*###*###*###*#######*#######*###*###*#*###*#####*#########*###*#*#####*###*#
*#*#***#*#*****#*#*#*********#***#*****#*****#*#*#***#***#*********#*******#*#*#*#*******#*#*#***#*#
*#*###*#*###*###########*#*#####*###*#####*###*#*###*###*###*#*#*#*###*#*###*#*#*#####*###*#*#*###*#
***#*#*******#*#*#*#*#***#*#*****#*****#***#*********#***#***#*#*#*#***#*#*#*******#*#*#*#*******#*#
##*#*###*#*###*#*#*#*#########*#*###*#########*#*#*#*###*###*#########*###*#*###*###*###*#*###*###*#
*****#*#*#*#***********#*#*****#*#*#***#*#*****#*#*#*#***#*******#*#*****#*****#*******#*****#*#*#*#
*###*#*#######*#*###*###*###*#*###*#*###*###*#*#########*###*#*###*###*#####*###*#*#*###*#######*#*#
*#*****#*#*#***#*#***#*******#*#*****#*******#*#*****#***#*#*#*****#*******#***#*#*#*******#*******#
*#####*#*#*###*#####*###*#*#*#####*#####*#*#*###*###*###*#*###*#*#*###*#*###*#######*#*#*###*###*###
***#*******#*****#*******#*#*#*#***#*****#*#*#***#*#*#*#*****#*#*#***#*#*******#***#*#*#*#***#*#***#
*#*###*###*###*#*###*#*#*#####*###*###*#*#######*#*###*#*###*#####*#####*#*#*#####*###########*#*###
*#***#*#*****#*#***#*#*#*#*****#***#***#*#*#*#*#***#*******#***#*****#*#*#*#*#*******#*#*#*#*#*****#
##*#*#####*#####*#########*###*###*###*###*#*#*###*###*#####*#####*###*#########*###*#*#*#*#*#*###*#
***#***#*****#***************#*#*********#*******#*#*****#***#*******#*******#***#***************#*#
*#########*#####*#*#*#*#*#*###*###*#*#*###*###*###*###*###*#*###*#*#####*###*###*###*###*#*#*#*###*#
*#*#*#*#*#*****#*#*#*#*#*#*#*****#*#*#*#*#***#*****#*****#*#*#***#*#*#*#*#***#***#*****#*#*#*#*#***#
##*#*#*#*#*###*###############*#*#######*#*###*#*#*###*###*#####*###*#*#####*###*###*###########*#*#
*#***********#***#***#*******#*#*****#*******#*#*#*#***#*#***#***********#*#*****#*#***#*****#***#*#
*#*###*#*#*###*#####*#*###*#*###*#*###*###*#######*###*#*#######*#*#*#*###*###*###*#*###*###*###*###
*****#*#*#*#*****#*******#*#***#*#*******#*#*#*#***#*****#*#*#*#*#*#*#*******#*#*******#***#*#*****#
*###########*#*#######*#####*#*###*#*#*#####*#*###*#####*#*#*#*#######*#*#*#######*#####*###*###*#*#
***#*****#***#*#***#*#***#*#*#***#*#*#*#***#*********#***********#***#*#*#*****#*#***#*****#***#*#*#
*###*###*###*#####*#*#*###*###*#*#######*#####*#*#*#####*#*#*###*#*#######*#*###*#*#####*###*#####*#
*#*#*#***********#*******#*****#*****#*#***#***#*#*#***#*#*#*#*****#*#***#*#***#*****#*#***#*#*****#
*#*#########*#*###*###*#########*#*###*#*#####*#######*###########*#*#*#####*###*#####*#*###*###*#*#
***#*#*#*#*#*#*******#*#*#*#*#***#*******#*******#***********#*#*********#*********#*******#*#***#*#
##*#*#*#*#*#########*###*#*#*#####*#########*#*#######*#*###*#*#####*###*###*#*#*###*#######*###*###
*************#*#*#*#*#*******#*#*#*#*#*#*****#*#*#*#*#*#*#*******#*****#***#*#*#*#*#*#*#*#***#*****#
*#*#*#*###*###*#*#*#####*###*#*#*###*#*###*#*###*#*#*#######*###*###*#############*#*#*#*#######*#*#
*#*#*#*#***#*******#*****#*******#*********#*#*********#*#*#***#*#***#*#*#*#*#*#*********#*#*#*#*#*#
*#########*###*###*###*#*###*###*###*#*#*#*###*###*#*###*#*#*###*###*#*#*#*#*#*###*#*###*#*#*#*###*#
*******#*******#*******#***#*#*******#*#*#*******#*#***********#*#*****************#*#*************#
####################################################################################################
