#***#*****
###*#*####
#*****#*#*
#*###*#*#*
#*#*******
########B*
#*#*#*#*#*
#*#*#*#*#*
#A********
##########
