####################################################################################################
***#*******#*#***#*#*#*#*#*******#*******#*********#*#*******#*#*#*#***********#*******#*******#*#*#
##*#*###*###*###*#*#*#*#*#*###*###*#####*#*###*#*###*#*###*###*#*#*#*###*#*#*#########*###*###*#*#*#
*****#*#*******#*************#***#*#*#*#*****#*#*********#***#*********#*#*#***#*#*#*#*****#*******#
*###*#*###*#*###*###*#*#*#*###*#####*#*#*#######*#########*#####*###########*###*#*#*#####*###*#####
*#*******#*#*******#*#*#*#*#*****#*#*******#*****#*#*#*#*******#*#*#*#*#***************#***#***#*#*#
*#####*#####*#*#*###########*#*###*#*###*###*#####*#*#*###*#*###*#*#*#*#####*#*#*#*#*#####*###*#*#*#
***#*#***#*#*#*#*#*#***#*****#*#*******#*#***#*#*********#*#***#*********#*#*#*#*#*#***#***#*******#
*###*#*###*#######*#*#####*#*###*###*#####*###*###*###*#####*###*#*###*###*#########*###*#*###*###*#
*#*******#*******#***#*****#*#*****#*#*#***#*******#*****#*****#*#*#*****#*****#*#*****#*#*#*#*#***#
*###*#######*###*#*#####*#*###*#######*###*###*#*#*###*#####*#####*###*#######*#*###*###*###*#####*#
*#*****#*****#*#***#*****#*#***#*#*********#***#*#*#***#*#*#*****#*#***#*#*#***********#*******#*#*#
####*###*#####*#*#####*#*#####*#*###*#*#######*#######*#*#*###*###*###*#*#*#####*#*#*###*#######*#*#
*#*#***#*#*#*#*****#***#*#*********#*#*#*#*#*******#*********#***#*#*******#*#***#*#*#*****#*#*#***#
*#*#*#####*#*#*#######*#########*###*###*#*###*#*#####*###*###*#######*###*#*###*#######*###*#*#*###
*******#*#*******#*******#*#*#*#***#*#*******#*#***#*#*#***#*#*****#***#*******#***#*****#*********#
*###*###*#*###*#####*#*###*#*#*#*###*###*###*###*###*#####*#*###*#####*#####*###*#######*###*###*###
***#*#*******#***#***#*#***********#*#***#*********#***#*******#*****#***#***#*#*****#***#***#*#***#
*#####*#######*#*###*#####*###*#*###*###*###*#*#*###*#######*###*#*#####*###*#*###*#####*###*#*#####
***#*#*#*#*#*#*#*#*******#***#*#*#***#*****#*#*#*********#*#***#*#*****#*#*******#***#***#*****#*#*#
*###*#*#*#*#*###*###*#*###*#######*#####*#############*###*#*#####*#*###*#####*###*#####*#####*#*#*#
*#*#*********#*#*#*#*#***#*#*#*****#*******#***#*#*#*#*#*#*****#*#*#***#*#*#*#***#***#*****#*******#
*#*#####*###*#*###*###*###*#*#########*#*###*###*#*#*###*#*#####*###*#####*#*#*###*#####*#*#######*#
***#*#*#*#*****#*********#***#*#*#*****#*#***#*********#*****#*#*#*******#*******#*****#*#*#*#*#*#*#
##*#*#*###*###*###*#*#*#####*#*#*###*#*###*#####*###*###*#####*#*###*#*###*###*###*#*###*###*#*#*#*#
*******#*#*#***#***#*#*#*************#*#***#*#*#***#***#***#*******#*#***#***#*#*#*#***#*#*********#
##*###*#*#####*###*#######*#########*###*###*#*#*###*###*###*#########*###*#####*###*#######*###*###
***#*****#*#*********#*#*#*#*#*#*#*#*****#*********#*******#***#*#*******#***#***#*******#*#***#***#
##*#####*#*###*#*#*###*#*###*#*#*#*###*#####*###*###*#*#*###*###*###*#*###*#####*###*#*###*#*###*###
*****#*******#*#*#*#*******#*********#***#***#*#*#*#*#*#*#***#*******#*#*****#*****#*#***#*****#***#
##*#######*###*#####*###*###*###*#*#########*#*###*#######*#####*#*#*###*#######*#####*###*#####*###
*******#*#***#*********#***#***#*#***#*#*#*#*****#*********#*****#*#*#*****#***#***#*****#***#*****#
*#*#*###*#*###*#*#*#*###*###*#####*###*#*#*###*#####*#*###*###*#*#####*#######*#*#####*###*#####*###
*#*#*#*#*****#*#*#*#*#*********#*************#***#***#*#*******#*#*#*****#***#***#*******#*#*#*****#
*#####*#*###########*###########*#*#*#*#*#*###*###*#*#####*#*#*###*#*#######*#*#####*#*###*#*###*###
***#*#*****#*#*******#*#*#*#*#*#*#*#*#*#*#***#***#*#*#***#*#*#*#*****#*#***#***#*****#*#*******#***#
*###*#*#####*###*#*###*#*#*#*#*###########*###*###*#####*###########*#*###*#*#####*#*###*###*###*###
*#*******#*******#*#*************#*****#*****#***#***#*#*********#*#*****#*****#***#*#***#***#*#***#
*###*#####*#*#########*#*#*###*###*###*###*###*###*###*###*###*###*###*###*#######*###*#*###*#*###*#
*#*****#***#*#*#*#*#***#*#*#*****#*#***#*****#*#*#*******#***#*******#***#***#*******#*#*#*****#*#*#
*###*#####*###*#*#*###*#######*###*###*###*###*#*#####*###*###*#*#*###*###*#####*#*###*#######*#*###
*#*****#***#***************#*****#*#***#*****#***#*#*#*******#*#*#***#***#*#*****#*#*******#*****#*#
*###*###*#####*#*#*#*#*#*#####*###*###*###*#####*#*#*###*#*#######*###*###*###*#*###*#*#########*#*#
*#*****#*#*****#*#*#*#*#*#*#*#***#*#*#*#*******#*******#*#*#***#*****#***#*****#*#***#*#*#*#*#*****#
*###*#######*#*###########*#*#*#####*#*###*#*###*###*#########*###*###*#####*#*###*#*###*#*#*#####*#
*#*#***#*#***#*#***#***#*#*******#*#*****#*#***#*#*#***#***#*********#***#***#*#***#*#*#*******#*#*#
##*#*###*###*#####*#*###*#*###*###*#*#######*#####*#*###*#####*#*#*###*###*#*###*#*###*#*###*###*#*#
*****#*********#*#***#*******#*#*****#*#*#*****#*******#*#*****#*#*#*****#*#*#***#*#*******#*******#
##*#####*#*#*###*#*#####*#########*###*#*###*#####*#####*###*#*#####*#####*#####*#####*###*#########
*#***#***#*#*#*#*****#***#*#*****#*#***********#*#***#*******#*#*#*****#*******#***#***#*#*#*#*#*#*#
*#*#####*#####*#*###*###*#*#####*#*###*#*#*#*###*#*#####*#*#*###*#*#######*#*#########*#*###*#*#*#*#
*****#*************#*#*******#*****#***#*#*#*#*******#***#*#*#*******#***#*#*****#*#*#***#*********#
*#######*#*#*#*#*###*#####*#####*#####*#######*###*###*#*#####*###*#####*###*#*###*#*###*###*#*###*#
***#*#*#*#*#*#*#*#***#*#*#***#*#*#*******#*****#*#*#***#*#***#***#*#*******#*#*********#*****#*#***#
*###*#*###########*###*#*#*###*#*###*#*###*###*#*#####*#####*#*#######*###*###*#*#*#*#####*#*#####*#
*#*********#*#*#***#*********#***#***#*#***#*****#*#*****#*******#*****#***#*#*#*#*#***#***#*#*#***#
*###*#*###*#*#*###*###*#######*#####*#####*#####*#*###*###*###*#######*###*#*#######*#####*###*###*#
*****#*#*******#***#***#*#*#***#*******#*****#*******#***#*#***#*#*#***#***************#*******#***#
##*#*#####*###*###*###*#*#*###*###*#*#####*#*#####*###*###*###*#*#*#######*#*#*#*#*#*#####*#######*#
***#*#***#*#*******#*********#*#***#*#*#*#*#***#*#***#***#*#*******#*#*#***#*#*#*#*#*#*****#*#*#*#*#
##*#####*#####*#*#*###*###*###*###*###*#*###*###*#*###*#######*###*#*#*###*#############*###*#*#*#*#
*****#*#*#*#*#*#*#*#*#*#*****#*#*****#*******#*#*****#***#*#***#*********#*********#*****#*********#
##*###*#*#*#*#######*#####*###*###*###########*#*#####*###*###########*###*#*#*#*#####*#*###*###*#*#
*****#*******#*#*******#*#***#*******#*#*#*#*#*****#*********#*#*#*#*****#*#*#*#***#*#*#*#***#*#*#*#
*#*###*###*###*#*###*###*#*###*#*#*###*#*#*#*#*#######*#*#*###*#*#*###*#########*###*###*###*#*###*#
*#*#*****#***#*****#*#*******#*#*#*#*#***********#***#*#*#***********#***#*#*#*********#*#*******#*#
*###*#####*###*#####*###*#####*#####*#*###*#*#*#####*#####*#*#*#*#*###*###*#*###*#*#*#########*###*#
*******#*****#***#***#***#*#*****#*#*****#*#*#*#*********#*#*#*#*#*******#*****#*#*#*****#*#*****#*#
*#########*###*#########*#*###*###*#*###########*#*#*###*#########*#*#*###*###*#####*#*###*###*###*#
***#*#*#*#*****#*#*#*#*****#*#*********#*#***#***#*#*#*#*********#*#*#*#*#***#*****#*#*******#***#*#
*###*#*#*###*###*#*#*#####*#*###*#*#*###*#*#####*#####*#*###*#*#*#######*#*###*#*#####*#*#*###*###*#
*#*#*******#*#*********#*****#*#*#*#*#*#***#*#*****#*******#*#*#***#*********#*#*****#*#*#***#***#*#
##*#*###*#######*###*###*###*#*#######*#*###*###*#####*#########*#####*###*#####*#*#######*###*###*#
*#*****#***#*#*#***#***#*#*******#*#*****#*********#***#*#*********#***#***#*#***#*****#*********#*#
*#*#####*###*#*#*###*###*#####*###*#*#######*#*#*#####*#*#####*#######*###*#*#######*#####*#*#*###*#
*****#*****#*******#***#***#*****#*****#*****#*#*#*#*******#***#*#*****#*****#*#*#*#*****#*#*#*#***#
*#####*#*###*###*###*###*#####*#####*#####*#*#####*#####*#######*###*#*#####*#*#*#*###*#*#######*#*#
***#***#*#*#***#*#*****#***#*#***#***#*#***#*#*#***#*#***#*#*#*******#*#*#***********#*#*****#***#*#
*###*#*###*#*#####*#*#######*#*#####*#*###*###*###*#*###*#*#*###*#*#*###*###*#*###*#####*#*#*###*###
***#*#*#*******#***#*#*#*#*******#***************#***#*******#***#*#*#*#*#*#*#*#***#*#*#*#*#*#*****#
*###*###*###*###*#*###*#*###*###*#########*#*#*#####*###*###*###*#####*#*#*#######*#*#*#####*###*#*#
***#*******#*#***#*#*******#***#*#*#*#*#***#*#*****#***#*#***#*******#*******#*#*********#*****#*#*#
*#####*#*#######*###*###*###*#####*#*#*#######*#*#####*#####*###*#*###*###*###*###*###*###*#*#####*#
*#*#*#*#*#*#*******#***#***#***#*#*******#***#*#***#***#*#*****#*#***#***#*******#*#*****#*#*#*****#
*#*#*#####*###*#*###*###*###*###*#*###*#####*###*#####*#*#####*###*###*###*#*#*#*#####*###*#####*#*#
*****#*#*******#*#*****#*****#*#*****#*****#*********#*****#***#*********#*#*#*#***#***#*#***#***#*#
*###*#*###*#*#*###*#####*#####*#*#####*#*#######*#*###*###*###*###*#*#*#########*#####*#*#######*###
*#*****#*#*#*#*******#*****#*******#*#*#***#*#*#*#*******#*#*#***#*#*#*#*#***#*****#*****#*#*#*****#
*#####*#*#####*#*#*###*#######*#####*###*###*#*###*#*#*#####*#*#########*#*#####*#*#####*#*#*###*###
***#*****#*#*#*#*#*#***#*#*#**A**#*#*#***********#*#*#***#***********#*******#*#*#***#*************#
*#*#####*#*#*#######*###*#*###*###*#*###*#*#*#*#######*#*###*#####*###*###*###*###*#*###*#*#*#*#*###
*#***#*******#*#*****#*******#*#*******#*#*#*#*****#*#*#*#***#*#*#*******#*****#*#*#***#*#*#*#*#*#*#
##*#####*###*#*#####*###*###*###*###*#########*#*###*###*###*#*#*###*#*###*#*###*###*#*###########*#
*******#*#*****#*#***#***#*****#*#*#*****#***#*#***#*#***#*********#*#*#***#*******#*#*****#***#*#*#
##*#*#########*#*###*###*#####*#*#*###*###*#####*###*###*###*###*###########*#########*#*#####*#*#*#
*#*#***#***#*****#*#*#*****#*******#*#*******#*****#*******#*#*****#*#*#*#***#*#*#***#*#***#*******#
*###*#####*#####*#*#####*#####*###*#*###########*#####*#*#######*###*#*#*#####*#*#*#####*#####*###*#
*#*****#*#*#*#*****#*********#*#*****#*#*#*#*******#***#*#***#***#*******#*#*******#*********#***#*#
*###*###*#*#*#####*###*#*#*#########*#*#*#*###*#*#####*###*#####*###*###*#*###*###*###*#*#*###*###*#
***************#*******#*#*******#*************#*#***********#*******#*********#*******#*#*******#*#
