##################################################
#*************#***************#*#*#*#*#*********#*
###*#*#*###*#####*#*#*#*#*###*#*#*#*#*###*###*###*
#***#*#*#*****#***#*#*#*#*#***************#*#***#*
#*#*#######*#####*###########*#*#*#*###*###*#*###*
#*#*#*#*#*****#*****#*******#*#*#*#*#*#*#*******#*
#*###*#*###*#####*###*#*###*#########*#####*#####*
#***#***#***#*#*****#*#*#*******#*#**A**#*#***#*#*
#*###*#####*#*###*###*#####*###*#*###*###*#*###*#*
#***#*#*#***********#*****#*#*****#*****#*****#***
#*###*#*###*#*#*#*###*#*#*#######*###*###*#######*
#***#***#*#*#*#*#*#*#*#*#*****#*#*#*********#*#*#*
#*#####*#*#########*#####*#####*#*###*#*#*###*#*#*
#***#*******#*********#*****#*#*****#*#*#*#*******
#*#####*###*###*#*###*###*###*#*###*#######*###*#*
#***#***#*******#*#*******#*******#***#*******#*#*
#*#####*###*#*#*#############*#####*###*###*#####*
#***#*****#*#*#***#*#*#*#*#*****#*****#***#*#*#***
#*###*#*###########*#*#*#*###*#####*###*#####*###*
#***#*#*******#*#*#*********#***#*********#*******
#*#######*#####*#*#*###*#*###*#####*#*#*#####*#*#*
#***#*#*#*#*#*#*******#*#*******#*#*#*#*#*#***#*#*
#*###*#*###*#*#*###*#####*#*#*###*#######*###*####
#*********#*******#*#*#*#*#*#*#*******#*#*#*****#*
#*#*#*#*###*###*#####*#*#######*#*###*#*#*###*###*
#*#*#*#***#***#*#*#*****#*******#*#*************#*
#######*###*#####*#*#######*#*#*#####*#*#*#*#*###*
#*********#*#*#*#***#*#*****#*#*#***#*#*#*#*#*#***
#*#*#*#*###*#*#*###*#*###*#*#####*###############*
#*#*#*#*#*#*******#***#***#*#*****#*********#*****
#*#######*#####*#####*###*###*###*#*###*#*#######*
#***********#*#***#***#*****#*#*******#*#*****#*#*
#*#*#*#*#*###*#*#####*###*#########*#####*#*###*#*
#*#*#*#*#*********#*********#*#*#*****#*#*#*******
#########*#*#*#*#####*#*#*###*#*###*###*###*#*#*##
#***#*#*#*#*#*#*#*#***#*#*#*******#***#*****#*#***
###*#*#*#########*###*#####*###*###*###########*#*
#*************#*********#*****#***#*#*#*#*#***#*#*
###*###*###*#####*#*#*###*#####*###*#*#*#*###*###*
#***#*****#*#*****#*#*#*****#*****#*******#*#*****
###*###*#######*#*#####*#####*#*#########*#*#####*
#***#***#*#*****#*#*******#***#*#***#*#*#***#*#***
###*###*#*###*#*###*###*#####*#####*#*#*###*#*###*
#***#*****#***#*#*#***#*#*******#*#*******#*****#*
#*#*#####*###*###*#*#######*#*###*#*###*#####*###*
#*#*#*#*********#*****#*****#*#*******#*****#***#*
#*###*###*#*#*###*#######*#*#####*#####*#*###*###*
#***#***#*#*#*#*****#*#***#*#*#*#***#*#*#*******#*
#*###*#########*#####*###*###*#*#*###*###*#*#*###*
#*****************#*****************#*****#*#*#***
