#*******#*#*********
#*###*###*#*###*#*#*
#*#*#*********#*#*#*
#*#*###*#*#*#######*
#**A**#*#*#*#***#***
#*#*###########*###*
#*#*#*******#*******
#####*###*#*###*#*#*
#*#*#***#*#*#***#*#*
#*#*#*#####*###*####
#*******#***#*******
###*#######*###*#*#*
#*#***#*******#*#*#*
#*#*#######*#######*
#***#*#*#*#*#*******
#*###*#*#*#####*#*#*
#*#*******#*#***#*#*
#*###*###*#*###*####
#*****#*************
####################
