***#*#***#
*###*###*#
*#**A**#*#
*###*###*#
*******#*#
##*#*###*#
***#*#*#*#
*#*###*#*#
*#*******#
##########
