##################################################
#*#*#*#*#*#*#*#*********#*#***************#*****#*
#*#*#*#*#*#*#*###*###*###*#####*###*#*#*#######*#*
#***************#*#*#*******#*#***#*#*#*****#*#***
#*#*#*#*#*###*###*#*#####*###*#*#######*#*###*#*##
#*#*#*#*#*#*#***#***#*#*#*********#***#*#***#*****
#*#########*#*#####*#*#*###*#*#######*###*###*###*
#*******#*#*****#*********#*#*#*#*#*#***********#*
#*#*#####*#*#####*#*###*#######*#*#*#########*###*
#*#***#*******#***#*#*****#*#*********#*#*#*#*#***
###*#*###*#####*#*#####*###*###*###*###*#*#*#####*
#*#*#*#***#*#*#*#***#***#*******#***#*********#***
#*###*###*#*#*###*#####*###*#*#*###*###*###*#####*
#*#***#*********#***#***#***#*#*#*******#*****#***
#*###*###*###*###*#####*###*#######*#*#*###*#####*
#*******#*#*****#***#***#*****#*#*#*#*#*#*#***#***
###*#*#######*###*#####*###*###*#*#######*#*###*#*
#***#*****#*****#*#*#*#*#*****#***#***#*******#*#*
#*#*#########*#####*#*#*###*#####*#*#####*#####*##
#*#*#*#*#*#*#***#*#*****#*******#*****#*#***#*****
#*###*#*#*#*#*###*#*###*#B#*#*###*#####*#*#######*
#*#**A**********#*****#***#*#*******#*#***#*#*#*#*
#*###*#*#*#*#*###*#####*#*###*#*#####*#*###*#*#*##
#***#*#*#*#*#*#*#*#*#***#***#*#***#*#***#*********
#*#*###########*#*#*#####*#####*###*#*#####*###*##
#*#***#*****#*******#*#***#*****#*****#*****#*#***
###*###*#######*###*#*#######*#*###*#####*###*#*##
#*****#*#*#*****#*******#*****#*#***#*****#*#*****
###*###*#*###*#*#####*#####*#*#####*###*###*#*###*
#*****#***#***#***#*#*#*****#*#*#*******#*******#*
###*#####*###*#####*#*###*#*###*###*#*#*###*#####*
#*****#*********#*****#***#*#*#***#*#*#*#*#***#***
#*#*#########*#####*#####*###*###*#######*#*#####*
#*#*#*#*#*#***#*#*#***#*********#***#*#*#*****#***
#*###*#*#*#####*#*#*#####*#*#*###*###*#*#*#####*#*
#***#*******#*******#*#*#*#*#*****#*#*******#***#*
#*###*###*#####*#####*#*#####*#*###*#*###*###*#*##
#*******#***#*****#***********#*#*#*****#*#***#*#*
#*#*#*###*#####*#####*#*#########*#*#########*###*
#*#*#*#*****#*****#***#*#*#*#*#*#*****#*********#*
#########*#####*#####*###*#*#*#*#*#######*#*#*###*
#*#*#*#*******#*#*****#*************#*#***#*#*#*#*
#*#*#*###*#*###*###*#*###*###*#*#*###*###*#####*#*
#*******#*#***#*****#*#*#***#*#*#*#*********#*****
###*#######*#######*###*#*#########*#*#*#*###*###*
#***#*#*#*******#*#*#*#*****#*#*#***#*#*#*#***#*#*
###*#*#*###*#*###*###*#*#####*#*###*###########*#*
#*********#*#*******#*****#*****************#*#***
###*#*###*###*#*#*###*#######*#*#*#*#*#*#*###*#*##
#***#*#*******#*#*******#*****#*#*#*#*#*#*********
