***#*#*#*#*#*********#***#*#*#***********#*#*#*#*#
##*#*#*#*#*#########*#*###*#*#*###*#*#*###*#*#*#*#
*************#*#*#*#***#*******#*#*#*#***********#
##*###*###*###*#*#*###*###*###*#*#####*###########
***#*****#***#*******#*#***#*****#*#*#*#*#*#*#*#*#
*#*###*###*###*###*###*###*#####*#*#*###*#*#*#*#*#
*#*#*#***#***#***#***#*#*****#*******#***********#
####*#*###*###*###*###*###*#####*###*###*#*#*###*#
*#*#*****#*******#*****#*******#*#*******#*#*#***#
*#*#*#####*#########*#*###*#*#*#####*#*#*#######*#
*******#***#*#*#*#*#*#***#*#*#*****#*#*#***#*#*#*#
*###*###*###*#*#*#*###*#*#####*#*#*#########*#*#*#
***#*#***#*********#*#*#*****#*#*#*****#*#*******#
*#####*#*###*#*###*#*###*#*#*#####*#*###*###*#####
***#***#*#***#*#*******#*#*#*****#*#*****#***#*#*#
*###*#*#####*#######*#######*#*#*###*#*#####*#*#*#
*#*#*#*#*****#*#*#*#***#*#*#*#*#***#*#***#*******#
*#*###*###*###*#*#*#*###*#*#####*#*###*#####*###*#
*****#*#***#***********#*****#***#*#*****#*#*#*#*#
##*#######*###*###*#*#####*#####*#####*###*###*#*#
***#*#*****#***#*#*#*#*#*#*#*****#*#*******#*#***#
##*#*###*#*###*#*#####*#*#*###*###*###*#####*#*###
*********#*#*******#*******#***#*********#*******#
##*#############*###*###*#####*###*#*#*#####*###*#
***#*#*#*#*#*#*****#*#***#*#***#***#*#*#*#*****#*#
####*#*#*#*#*###*#######*#*###*###*#####*###*###*#
*#*************#*#*#*#*#***#***#*******#*#*****#*#
*###*#*#*###*###*#*#*#*###*###*###*#*###*###*#####
*****#*#*#*****#*********#*#*****#*#***#*#***#*#*#
*#*#*#######*###*#*###*###*###*#####*###*###*#*#*#
*#*#*#*#*#***#*#*#*#***#*#*****#*******#*#*******#
*#####*#*###*#*###*###*#*#####*###*#*###*###*###*#
***#*****#*****#*#*#*****#*#*#*#***#*#*****#*#***#
*###*###*#####*#*#######*#*#*#####*#####*#######*#
***#*#*****#****A**#*#*#*****#*******#*#*****#***#
*#########*###*#*###*#*#####*###*#*###*#*#######*#
***#*#*#***#*#*#*#*******#*******#*#*******#*#*#*#
*###*#*###*#*#####*###*#####*#*#*#####*#####*#*#*#
*********#***********#*****#*#*#***#*#***#*#*****#
*#*#*#*###*###*#*#*###*#*#######*###*#*###*#*###*#
*#*#*#***#*#*#*#*#*#*#*#*****#*#*******#*#*****#*#
######*###*#*#######*###*#*###*###*#####*#*#####*#
*#*#*****#*****#*#*#***#*#*******#*#*#*#*****#***#
*#*###*#####*###*#*#*#####*#*#*#####*#*#*#######*#
***#*****#*#***#*****#*#*#*#*#***#*********#*#***#
##*###*###*#*###*###*#*#*#####*#####*###*###*###*#
***#*****#*****#*#***************#*#***#*#***#***#
##*###*###*#####*###*#*#*#*#*#*###*#*#######*###*#
*************#*****#*#*#*#*#*#*********#*********#
##################################################
