####################################################################################################
*****#*#*******#*#***#*******#*****************#*******#*#*********#***#*#*#*#*#*#***********#*#***#
*###*#*#*###*###*###*###*###*###*#*###*###*#######*###*#*#*###*#*#####*#*#*#*#*#*#*#####*#####*#*###
*#*********#*******#*****#*#*#***#*#*****#***#*#***#*********#*#*****#*************#*#*#***#*******#
*###*###*#####*#*#####*###*#*###*#####*###*###*###*#####*#######*#*###*#*#*#*###*###*#*#######*###*#
***#*#***#*#*#*#***#***#*****#*****#***#*#*#*********#*****#***#*#***#*#*#*#*#***#**A****#*#*#***#*#
*#######*#*#*###*#####*###*#####*#####*#*#####*#*#*#*###*###*#####*###*#########*###*#*###*#*#*###*#
***#*#*******#*#*****#*#***#*#*****#*****#*#***#*#*#*#*#***#***#*****#***#*#*#*#***#*#***********#*#
*###*###*###*#*###*###*###*#*###*#*#####*#*###*#######*#*###*#####*#######*#*#*###*###*#*#*#*#*###*#
***#***#*#*******#***#*#*******#*#***#*****#*******#*******#***#*******#*#*******#***#*#*#*#*#*#***#
*###*#########*###*#####*###*#####*#*#####*###*#*#####*#####*#####*#*###*#*###*#####*###########*#*#
***********#*#***#***#*#*#***#***#*#***#*****#*#***#*#***#***#*#*#*#***#*****#***#*#*#*#*#*#*****#*#
######*#####*#*###*###*#####*#*#####*#*#####*###*###*#*###*###*#*###*###*#####*###*#*#*#*#*###*#*###
*#*#*#*#*#*#*****#*******#*****#***#*#***#*******#*#*****#*#***********#***#*****#*********#***#*#*#
*#*#*###*#*#*#####*#*#*###*###*#*#####*#*###*#*###*#*#####*###*#*#*#*###*###*#*###*###*#*#####*###*#
*******#*******#*#*#*#***#*#*********#*#***#*#*#*******#***#***#*#*#*#*****#*#*#*****#*#*#*******#*#
*###*###*###*###*#####*###*#####*###*###*#*#######*#######*###*#######*#####*###*###*#######*#*###*#
***#*******#*#*****#*****#***#***#*#***#*#***#*#***#*#*#*********#*******#*********#*#*#*****#*#***#
*#######*#####*#######*#########*#*###*###*###*###*#*#*#####*#*###*###*#####*#*#*#####*###*#*#####*#
*#*#*#*#*#*****#*#*#*******#*#*******#*#*******#*******#*#***#*#*****#*#***#*#*#***#*******#*#***#*#
*#*#*#*#######*#*#*###*#*###*#####*###*###*#*#*###*###*#*###*###*#######*#######*#####*#*#*#####*#*#
*******#*#*#*********#*#*******#*****#***#*#*#***#*#*******#*******#*****#*******#*#***#*#*#*******#
##*###*#*#*#####*###*###*#*#*#####*###*#*#####*#########*###########*###*###*#*###*###*#####*###*###
***#*********#***#*****#*#*#*****#***#*#*#*#*****#***#***#*#*#*#*#***#***#***#*#*********#***#*****#
##*###*###*###*#*#####*#####*#*###*###*###*###*#####*###*#*#*#*#*###*###*###*#####*#*#*#####*###*###
*****#*#*****#*#***#*#*#*#*#*#*******#*#*********#***#*************#*#*********#***#*#*#*#***#*****#
##*#######*###*#####*#*#*#*###*#*#*###*###*#*#*#####*###*#*#*###*###########*#####*#####*###*###*###
*****#*#*****#***#***********#*#*#*#***#***#*#*#*******#*#*#*#*****#*#*#*#***#*******#*******#*#***#
##*###*###*###*#*###*###*#*#*#######*#*###*#######*###*#########*###*#*#*###*###*#*#####*#*###*#*###
*******#*#***#*#*#*****#*#*#***#*****#*#*********#*#*********#***#*******#*#*#***#*#*#***#*#*******#
*#*#####*#*#####*###*#######*#####*#*#####*#*#*#######*###*#####*###*###*#*#####*###*###*#####*###*#
*#***#*******#***#*****#*****#*****#*#*#*#*#*#*****#***#*****#***#***#*******#*****#*******#*#***#*#
########*#####*#*###*###*#*#####*#*###*#*#####*#*#####*###*#####*###*#####*#####*#######*###*#*###*#
*#*#*#*****#***#*#***#*#*#*#*****#*#*#*******#*#***#***#***#*#*********#***#*#*******#***#*******#*#
*#*#*###*#####*#####*#*#######*#*###*#*###*#####*#########*#*###*#*#*#####*#*###*#*#####*###*#####*#
*******#***#*****#*****#*#*#***#*#*******#***#*******#*#*#*****#*#*#*#*#*******#*#*****#*#*****#***#
*###*###*#####*#*#####*#*#*###*###*###*###*#*###*#*###*#*#####*#######*###*###*###*#*###*###*#####*#
***#***#***#*#*#***#*****************#*#***#***#*#*********#*#*******#*#*#*#*****#*#***#*#*#***#***#
*###*###*###*###*#####*#*#*#######*#######*#######*#*#*#*###*#*###*###*#*#####*#####*#####*#*###*#*#
***#*******#*******#*#*#*#*#*#*#*#*#*******#*#*#*#*#*#*#***#*****#*******#*#*#*#*******#*******#*#*#
*###*#*#*#####*#*###*#######*#*#*#######*###*#*#*#######*###*#####*#*#*###*#*#*###*#*#####*#####*###
*#*#*#*#*#*#***#*#*#*#***#*******#*#*#*#*#***********#*****#*#*#*#*#*#*#*******#***#*#*#*#***#*****#
*#*#######*###*###*#*#*#####*###*#*#*#*#####*###*#######*###*#*#*#####*###*###*###*###*#*#*#####*###
*****#*#*********#*******#***#*********#*#***#***#*#*******#*******#***#*#***#*#*****#*******#*****#
##*###*###*#*#*###*###*#####*###*#*###*#*###*###*#*###*#*###*###*###*###*#*#######*#####*###########
*****#*#***#*#*#*****#***#*****#*#*#*********#*****#***#*#***#*#***#*#*******#*******#*****#*#*#*#*#
##*###*###*#######*###*#*###*#########*#*#*#*#####*###*#######*#*###*###*###*###*#*#####*###*#*#*#*#
*#***#*#*********#***#*#*#*********#*#*#*#*#*#*#***#*****#*#*#*****#*#*****#*#***#*#*****#*********#
*#*###*###*#*#*###*#####*###*#*#*###*#########*###*###*###*#*#*#####*###*#######*#######*###*#*###*#
*****#***#*#*#*******#*****#*#*#***#*******#***#*********#*******#***#***#*#*#*******#*#*****#*#***#
*#######*###*###########*#######*#####*###*#*#####*#*#*###*#########*###*#*#*###*#*###*#####*#####*#
***#*********#*#*#*#*#*#*****#*****#***#*********#*#*#*#***#*#*#*#*#*#*********#*#*******#*#*#*#*#*#
*###*#########*#*#*#*#*#########*#####*###*###*#########*###*#*#*#*#####*###*#####*#*#*###*###*#*#*#
***#*#*#*#*#***********#*#*#*******#***#***#*#*****#*#***#*#*********#*#*#***#*#*#*#*#*******#*****#
*#####*#*#*###*#*#*###*#*#*###*#*#####*###*#*###*###*#*###*#*###*#*###*#####*#*#*#####*#*#*###*###*#
***#*******#***#*#*#***********#*#*****#*******#***#***#*******#*#*******#***********#*#*#***#*#*#*#
*#####*###*###*#######*#*#*#*#*###*#########*###*###*#####*#######*#*#*###*###*###*#######*###*#*###
*#*****#***#*****#***#*#*#*#*#*#***#*#*#*#*#***#***#***#*#***#***#*#*#***#*#***#*#*#*#*******#*****#
*###*#*###*###*###*#################*#*#*#*#*###*###*###*#*#####*#####*#######*#*###*###*#*#####*###
*****#*#***#*********#*#*********#*#***********#*****#*#*****#***#*******#*#*#***#*******#*#*#*#***#
##*#*#####*###*#*#*###*#*###*#*###*#*###*#*#*###*#####*#*#######*###*#*###*#*###*###*#*#*###*#*#*###
***#*#*#*****#*#*#*********#*#*********#*#*#*#*****#*******#***#*#***#*#*******#*#***#*#*#*#*******#
*#*###*#####*#####*#*#*#*#####*#*#*#*###########*#*###*#######*#*###*###*###*###*###*#####*#*###*###
*#*#*****#*******#*#*#*#*#*#*#*#*#*#*#*#*#*******#*#*#***#*******#*****#***#*****#*****#*******#***#
*###*###*#####*###########*#*#########*#*###*#*#*###*#*###*###*#####*###*###*#######*###*###*###*###
***#***#***#***#***************#*#***********#*#*#*******#*#***#***********#*#*#*******#***#*#*****#
*###*###*#####*###*###*###*#*###*###*#*#*#*#*#######*#####*###*###*###########*###*#*###*#####*#*###
*******#***#*******#***#*#*#*#*******#*#*#*#*#***#*****#***#*******#*#*#*#*#*******#*#*****#***#*#*#
*#*#*###*#####*#*#*###*#*#######*#*#*#########*#####*#####*###*#*###*#*#*#*###*#*#*###*#####*#*###*#
*#*#*#*****#*#*#*#*#*******#*#***#*#*#*#*********#*#***#*****#*#*#*********#***#*#*#*****#***#*#***#
########*###*###########*###*###*#####*#*###*#####*#*#####*#*#######*#*###*###*#######*###*#*###*###
*********************#*#*#*********#*#*****#*#*#*#*****#*#*#***#*****#*#***#*******#*#***#*#*#*****#
*#############*#*#*###*#*###*#*#*###*#*###*###*#*#*#####*###*#####*#*#####*###*#*###*#*###*###*#####
*#*#*#*#*#*#*#*#*#*#*****#***#*#*#*******#*#*********#*#*#*****#***#*#*#*****#*#*********#***#*#*#*#
##*#*#*#*#*#*#########*#####*#####*###*#######*###*###*#*###*#####*###*#####*###*#*#*#*###*###*#*#*#
*#*************#*#*#*****#*****#*#***#*#*#*#*#***#*#*****#*****#*********#***#*#*#*#*#*#*****#*****#
*#*###*#*#*#*###*#*###*#####*###*#*#####*#*#*#*#######*#####*#*###*#*#*#*###*#*###########*###*###*#
*****#*#*#*#*********#*#*******#*****#*#*********#*****#***#*#***#*#*#*#*#*********#***#*****#*#***#
*###########*#*#*#*###*###*#*###*#####*#*###*#*###*###*#*#####*#########*###*###*###*#####*#######*#
***#*****#*#*#*#*#***#*#***#*#***#*#*#*****#*#*#***#*****#*#*******#*****#***#*#*******#*****#*#*#*#
*###*#####*#######*###*###*###*###*#*#*#########*#*#####*#*###*#######*#*###*#*###*#######*###*#*#*#
***#*#*#*******#*****#*********#*#*******#*******#*#*#***********#*****#*#*******#*#*#*#***********#
*###*#*###*###*###*###*#*#*#####*#*#########*#*#*###*###*#*#########*#*#######*#####*#*###*#*#*#*###
***#*******#*********#*#*#***#*******#*#*#*#*#*#*******#*#*#*#*#*#***#***#*#*#***#*******#*#*#*#***#
*#####*#*#########*#######*#####*#####*#*#*#########*#######*#*#*###*#####*#*#*#####*###*#######*###
***#***#*#*#*#*#*****#*#*#***#*#***#*******#*#*#*#*#*****#*************#*#*****#*#***#*******#*****#
*#####*###*#*#*###*###*#*#####*#*#####*###*#*#*#*#*###*#####*#*#*#*#*###*#*#####*###*###*###*###*#*#
***#***#*******#*#*********#*#***#*****#*************#***#***#*#*#*#*#*******#*********#*#*****#*#*#
*###*#####*###*#*#####*#*###*#*#####*#*###*#*#*###*###*#####*###########*#######*#*#*#########*###*#
*#*#*#*****#*****#*#*#*#***#*****#***#*#*#*#*#*#*#***#*#*******#*****#***#*#*#***#*#*#*#***#*******#
*#*#####*#*#####*#*#*###*###*#######*###*#######*#*#######*#*###*###*###*#*#*###*#####*#*#####*#*#*#
***#*#***#*#*#*******#*#*******#*******#*****#*******#*****#*#*****#*#*************#*********#*#*#*#
##*#*###*###*###*###*#*###########*#*###*###*###*###*###*#*#####*###*###*#*#*#*#*#####*###*#########
*****#*******#*#*#*****#*#*#*#*#***#*#*#***#*#***#*#*#***#*#***#***#***#*#*#*#*#*#*#*#***#*********#
*###*###*#*###*#######*#*#*#*#*###*###*#*###*###*#*#####*#####*#*###*#*###########*#*#*###*#*#*#*###
*#*****#*#***#*#***#***********#***********#*#*****#*******#*#*****#*#*******#***********#*#*#*#***#
*#####*###*###*#*#####*#*#*###*###*#*#*#*###*#####*###*#*###*#*#######*#*#*#########*###########*###
***#***#*****#*******#*#*#*#***#*#*#*#*#*#*****#***#***#*#*#*****#*#*#*#*#***#*#*#*#***#*#*#*#*****#
*#*###*###*###*###*###########*#*###########*#####*###*###*#*#####*#*#####*###*#*#*#*###*#*#*###*###
*#*#*************#*********#*******************#***************#***********************#***********#
