#*#*#*******#*#*#*#*#*#*******#***#***#*#*#*#*******#*******#*******#*****#*#*#*#*#*#***************
#*#*###*###*#*#*#*#*#*#*###*#####*#*###*#*#*###*###*###*###*###*###*#*#####*#*#*#*#*#*###*#*#######*
#***#***#*****************#***#*****#*********#*#***#***#*******#*#*****#***************#*#*#*#*#*#*
###*###*###*###*###*#*#*###*###*###*###*###*#######*###*###*#####*#*###*###*#*###*###########*#*#*##
#*********#*#***#*#*#*#*#*****#*#***#*****#*****#***#*****#*#*#*#*****#*#***#*#*#***#*#*#*#*******#*
###*#*#*#######*#*#########*###*###*###*###*#*#####*###*#*###*#*#*#########*###*#*###*#*#*###*###*#*
#***#*#*#***#*****#*#*********#*#***#*****#*#*****#***#*#*#*******#*#*#*****#*#***#***********#*****
###*#######*#####*#*#####*#*###*###*###*#####*#*#####*###*###*#####*#*###*###*#*#####*#*#*#*#*#####*
#*****#*****#*#*******#***#*#***#***#*****#*#*#***#*******#***#*#*********#*#***#*****#*#*#*#***#*#*
###*###*###*#*#####*###*#*#####*###*###*###*###*#####*#######*#*###*#*#*###*#*#####*#*###########*#*
#*****#*#*#*****#*#***#*#*#*****#***#*****#*********#*#*#*#*#*******#*#*#*#***#*****#*#*#*#***#*#***
#*#*#####*#*#####*#*###*#####*#####*###*###*#####*#####*#*#*#####*#*#####*#*#####*#*###*#*#*###*#*##
#*#*#*******#*#*#*****#***#***#*#*#*#***#*#*#*#*#*****#*******#***#*#*#*******#***#*#*******#*******
#*#######*###*#*#*#####*###*###*#*#*###*#*###*#*###*###*###*#####*###*###*#######*###*###*#####*###*
#*****#*#*#*********#*****#*#*******#*****#**A****#*******#*****#*****#***#*#*#*****#*#*#***#*#***#*
#*#*###*#*###*###*#####*###*###*###*#####*###*#*###*#*#*###*#*###*#*#*###*#*#*###*#####*#*###*#*###*
#*#*******#*#***#*#*#*****#*#*****#***#***#*#*#***#*#*#*#*#*#***#*#*#*#*******#*******#***#*******#*
###*#######*#*#####*###*###*###*###*#*###*#*###*#########*###*#######*###*###*###*#*###*#####*#####*
#*****#*#*#*****#***#*****#*#*#***#*#*#*****#*****#*******#*****#*******#*#*****#*#*******#*#***#***
#######*#*#*#####*#####*#####*#*#####*#####*###*#####*###*###*#######*#######*#####*#######*#*###*#*
#*#*#*#*******#*#***#*****#*#*****#*****#*********#***#*********#*#*#*****#*#***#*****#*#*#*****#*#*
#*#*#*#*###*###*#*#####*###*#*#####*#*#####*#*#*###*#*###*#*#*###*#*###*###*#*#####*###*#*#*#####*##
#*********#*#*******#***********#***#*#***#*#*#*#***#*#*#*#*#*#*******#*#*#***#*****#*#*******#*****
#*###*#*#####*###*#####*#*#*#*###*#*#####*#########*###*#######*###*#####*#*#####*###*#*###*#####*##
#***#*#*#*#*****#*****#*#*#*#*#***#*#***********#*****************#***#*****#*****#*#*****#*#*#*****
#*#######*#*#####*#*#*###########*#####*#######*###*#*#*#*#*#*#*###*#####*#####*###*#*#######*###*#*
#***#*******#*#*#*#*#***#*****#*****#***#*#*#*#*#*#*#*#*#*#*#*#*#*****#***#*****#*******#*****#*#*#*
#*#########*#*#*#####*#####*#####*#######*#*#*#*#*#################*#####*###*#*###*#####*###*#*###*
#***#*#*#*#*******#*******#*#*#*******#*****************#***#*#*#*******#*****#*#*****#***#*********
#*###*#*#*#####*#####*#*###*#*###*#*#####*###*#*#*#*#*#####*#*#*###*#*#####*#*#####*###*#*###*#*#*#*
#*#*********#*****#*#*#***#*****#*#***#***#*#*#*#*#*#*****#*******#*#*****#*#*#*#*#***#*#***#*#*#*#*
#*###*###*#####*###*###*#####*#####*#####*#*#########*#*###*#*###*###*#*###*###*#*#*###*###########*
#*#***#*****#*#***#*#*******#*#*******#*****#*#*****#*#***#*#*#*****#*#***#*#*********#*#*#*#*#*#*#*
#*###*###*###*#*###*###*#*###*###*#*###*###*#*#####*###*###*#######*###*###*###*###*#*###*#*#*#*#*##
#*****#*#***#*****#***#*#***#*#***#*#***#*****#*#***#*****#*****#***#*****#*#*****#*#*#***********#*
#*#*###*#*###*#####*#####*###*###*#####*#####*#*###*###*#####*#*###*###*#######*#########*#*#*###*#*
#*#*#*******#***#***#*******#*#*******#***#*****#*#*******#*#*#*#***#*******#***#*#*#*****#*#*#*****
#*#####*#####*#####*###*#*###*###*#*###*#######*#*#####*###*#######*###*#*#####*#*#*###*#*#########*
#***#*#***#*#*#*#*#*****#*#***#*#*#***#*****#*******#*********#*#***#*#*#*****#*****#***#*****#*#*#*
#*###*#*###*#*#*#*#####*#####*#*###*###*#*#*#####*#########*###*###*#*###*#*###*###*###*#######*#*#*
#*#*******#*********#*****#*#***#*****#*#*#***#*****#*#*#*#*******#*****#*#***#*#*********#*#*#*****
#*###*#####*#*###*#####*###*#*#####*#######*#*###*###*#*#*###*#*###*###*###*###############*#*#*###*
#*#***#*#***#*#***#*#*#*******#*******#*****#*#***#*********#*#***#*#***#*****#*#*#*#*#*#*#*******#*
#*###*#*###*#####*#*#*###########*#*#########*###*###*###*#####*###*###*###*###*#*#*#*#*#*#*###*###*
#*#*****#*#***#*******#*#*#*#*#***#*#*#*#*#***#***#***#*****#*****#*#***#*********************#*#***
#*#####*#*###*###*###*#*#*#*#*###*###*#*#*###*###*###*###*###*#*#######*###*#*#*#*#*#*#*#*#*#######*
#***#*******#***#*#***********#*****#*******#*#*******#*#***#*#*#*#*#*#***#*#*#*#*#*#*#*#*#*#*#*****
#*#*#####*###*#######*#*#*###*###*###*###*#######*#####*#*###*###*#*#*###*###################*###*#*
#*#***#*****#***#*#*#*#*#*#***#*********#*****#***#*#*#*****#***********#*****#***************#***#*
###*#*###*###*###*#*#########*###*#*#*###*#*###*###*#*#*#####*#*#*#*#*###*#######*#*#*#######*###*##
#***#*#*#***#*********#***#*****#*#*#*#*#*#***#*#*#*******#*#*#*#*#*#***#*#*#*****#*#*#*#*#*#*#*****
###*###*#*###*#*#*#*###*#######*#######*###*#####*#*###*###*#########*###*#*###*#*#####*#*#*#*###*#*
#***#*#*****#*#*#*#*******#*#*******#*#*#*****#*#*****#*#*********#*****#*******#*#*#*********#*#*#*
#*###*#*###########*#*#*###*###*###*#*#*###*###*#*#######*#*#*###*###*#####*#*#*###*###*###*###*###*
#*#*#*****#*******#*#*#***#***#*#*******#***********#*****#*#*#***#*******#*#*#*#***#*#***#*#*******
###*#*#####*#*###*#####*#####*#####*###*###*#########*#*#*#######*###*#*###*#####*###*#*#######*#*#*
#*#*****#***#*#***********#*#*****#*#*********#*#*#*#*#*#*#*#*#*#***#*#***#*******#*******#*****#*#*
#*#*#######*#####*#*#*#*###*#*#########*#*#*###*#*#*#######*#*#*###*###*#######*#####*#######*#*####
#*****#*#*******#*#*#*#*#*****#*#*#*#*#*#*#*#*******#*#*#*********#*#*******#*#***#*#***#*****#*#*#*
#*#####*###*#*###########*#####*#*#*#*#########*###*#*#*###*###*###*###*#*###*#####*#*#####*#*###*#*
#*#*#*****#*#***#*******#***#*********#*#*#*#***#*********#***#*****#*#*#*******#*****#*****#*#*****
#*#*###*#####*#########*#*#####*#*###*#*#*#*###*###*###*###*###*#####*###*#*#*#####*#####*#*###*###*
#*****#***#*******#*#*#***#*****#*#***************#*#*****#*#*#*#*#*******#*#***#***#*****#*#***#*#*
###*###*#####*#*###*#*#*#####*#*#####*#*#*#*#*#*#######*###*#*###*###*#######*#####*###*#*###*###*#*
#*#***#*#*#*#*#*********#*****#*#***#*#*#*#*#*#*#***#***#*#***#*******#*#*#*#*****#*#***#*#***#*****
#*#*###*#*#*###*#*#*#######*#*###*#################*###*#*###*###*#*###*#*#*###*###*###*#####*###*##
#*****#*******#*#*#*#*#*#***#*#***#*#*#*#*******#***#*******#*#***#*#*********#***#*#*******#*#***#*
#*#######*#######*###*#*###*#####*#*#*#*#*###*#####*#####*###*###*#####*###*###*###*###*#*#######*#*
#***#*******#*****#***********#*************#***#*#*#*#*****#*******#***#*****#*******#*#*****#*****
#*###*###*#####*#####*#*#*#*###*#*#*###*#####*###*#*#*###*#######*#*###*###*###*#*#*#####*#*#######*
#***#*#***#*#***#*****#*#*#*#***#*#*#***#*#*#*********#***#*#*#***#*#***#***#*#*#*#***#*#*#***#*#***
#*#######*#*###*###*#*#########*#######*#*#*###*#########*#*#*#########*###*#*#####*###*###*###*###*
#*#*#*#*#*******#***#*#*#***********#*******#*#***#*#*#*******#*#*#*****#*******#*******#*********#*
#*#*#*#*#####*#*###*###*###*#*#*#*#*###*###*#*#####*#*#B#*###*#*#*###*#*#####*###*#*#*#####*#*#*###*
#*******#*#*#*#*#*****#*****#*#*#*#***#*#*******#*******#*#***********#*#*#***#*#*#*#***#*#*#*#*****
###*###*#*#*###*###*###*#*#########*#*#######*#####*###*#####*#*#*#*#*###*###*#*#####*###*#####*#*##
#***#*********#*#*****#*#*#*#*#*#*#*#***#*#***#*****#*******#*#*#*#*#*#*#*#*******#*****#*#***#*#***
###*###*###*#######*#######*#*#*#*###*###*###*###*#*#######*###########*#*#####*###*#*###*#*#####*#*
#*****#*#*#***#*******#*#*#*********#***#*#*******#***#*#*#*********#*******#*****#*#*#*#***#*#*#*#*
#########*#*#####*#*###*#*#*###*#*###*###*###*#*#*#####*#*#*###*#*#####*###*###*###*###*#*###*#*###*
#*#*#*#*****#*****#*#*#*******#*#***#*******#*#*#***#*#*******#*#***#***#***#*****#*******#*********
#*#*#*###*#####*#*###*#*###*#####*###*#*#*###########*#*###*#####*#####*###*###*###*#*#*#####*#*#*#*
#*******#*#*#***#*#*#*****#*#*#*****#*#*#***#*****#*#*****#*#*#*******#*#***#***#*#*#*#*#*****#*#*#*
#*###*###*#*###*###*#*#######*###*#######*###*#####*#*#######*###*#*###*###*###*#*#####*###*#*######
#***#***#***#***********#*#*********#*********#*#*#*****#*******#*#***#*#*#*#*******#***#***#*#***#*
#*###*#####*###*#*#*#*###*###*#*#*#########*###*#*#*#####*###*#*###*#####*#*#####*#########*#####*#*
#***#*****#*#*#*#*#*#*#*#*****#*#*#***#*#*#*#*********#*****#*#*#*****#*#*****#***#*#*#*******#*#***
#*#####*###*#*#########*###*#*#######*#*#*#####*###*###*#####*#####*###*#*###*###*#*#*###*#*###*#*##
#*#*#*#*********#***#*#*****#*#*************#*****#*#*****#***#*******#*****#*#*******#***#*#*******
#*#*#*###*#*#*#####*#*###*#*###*#*###*###*#####*#####*#####*#####*#*###*#####*###*###*###*#####*###*
#*****#*#*#*#***#*#***#***#*#***#*#*#***#***#***#*#***#*#*#*#*****#*#*****#*****#*#***#*******#***#*
#*###*#*#####*###*#*#####*###*#*###*#*###*#####*#*###*#*#*#####*#*###*#######*#######*###*#*###*###*
#*#*****#*#***********#*****#*#*#*******#***#*******#*****#*****#*#*#***#*#*******#*****#*#*******#*
#*#####*#*###*###########*#####*###*#####*###*###*###*###*###*#*###*#*###*###*#*#*#####*###*#*#*###*
#***#*****#*#*#*#*#*#*#*******#*#*#***#*****#*#*#***#*#*******#*#*#*****#***#*#*#***#***#*#*#*#*#***
#*#######*#*###*#*#*#*###*#*#####*#*###*#*#####*#*###*###*#*#*###*#*#####*#######*#####*#*#######*#*
#*****#*****#***********#*#*****#*****#*#*#*#*#*****#***#*#*#*#*#*****#*#*#*#*#*****#*****#*#*#***#*
#*#*#*#####*###*#*#*###*###*#*###*#####*###*#*#*#####*#*#######*#*#####*#*#*#*###*#######*#*#*###*##
#*#*#***#*******#*#*#*******#*******#*************#***#*************#*****************#*************
####################################################################################################
