####################################################################################################
***************#*******#*******#*************#***#*******#*******#***#*******#*#*********#*#*******#
*#####*#*#*#######*###*#*###*###*#########*#####*#*###*#####*###*#*#####*###*#*###*#*###*#*#*###*#*#
*#*#*#*#*#***#*****#*****#*#*******#*#*#*#*****#*****#*****#*#*#***#*****#*********#*#*******#*#*#*#
*#*#*#####*#####*#*#####*#*###*#*###*#*#*###*###*#####*#*#####*#*#####*#*###*#*#*#*#########*#*###*#
*****#*#*****#***#*#*#*******#*#*#*******#*#*******#***#***#*#***#*****#*#*#*#*#*#*#*#*#*#*#***#*#*#
*###*#*###*#####*###*#####*#####*###*###*#*#############*###*#*#####*#*###*#########*#*#*#*###*#*###
*#*******#***#*****#***#*****#***#***#*******#*#*#*#*#*********#*****#*#*****#*#*#***********#***#*#
*#####*#########*###*#####*###*#*###*#####*###*#*#*#*###*#*#*#*###*#*###*###*#*#*###*###*#*#####*#*#
***#***#*#*#***********#***#*#*#*#*****#***#***********#*#*#*#*#***#*#***#*******#*#***#*#***#*#***#
######*#*#*###*#*#########*#*###*###*#*###*###*#*###*#############*#####*###*#####*#*#####*###*###*#
*#*#*#*********#*#*#*#*#*******#*#*#*#*#*******#*#***#*#*#*#*#*******#***#*****#*******#*********#*#
*#*#*###*#*#*#*###*#*#*#####*#####*###*###*#*#*#####*#*#*#*#*###*#*#####*###*#####*###########*###*#
*******#*#*#*#*#*********#***#*#*********#*#*#*#*#***************#*#*****#*****#***#*#*#*#*#*#*****#
*###*###*#########*###*#####*#*###*#*#*#########*###*#*#*#*#*#*#*#####*#*###*#####*#*#*#*#*#*#####*#
***#***#***#*#*#*#***#*****#*******#*#*#***#*******#*#*#*#*#*#*#*#*#***#*#*****#*************#*#*#*#
*###*###*###*#*#*#*###*#*###*#*#*#*#######*#*###*#################*###*#####*#####*#*#*#*###*#*#*###
***#***#*#***********#*#***#*#*#*#*#*#*#*#*****#*****#***********#*#*****#***#*#*#*#*#*#*#*******#*#
*###*#######*###*#*#####*###*#######*#*#*#*#####*#*#########*###*#*###*#*###*#*#*###########*###*#*#
***#***#*#*****#*#*#*#*****#***#*#*#*********#*#*#***#*#*#*#*#*******#*#*#***********#*#***#*#*****#
*###*###*###*#######*###*###*###*#*#*###*#*###*###*###*#*#*#####*###*###*#####*###*###*#*#########*#
*#*#*******#*#*#***********#***#*******#*#*#*#*#*************#***#*********#*#***#***#*********#*#*#
*#*###*#*###*#*#####*#*#*###*#####*#########*#*###*#*#*#*#*###*#######*#*###*#*###*#####*#######*#*#
*****#*#***#*****#***#*#*#*******#***#*#*#*#*****#*#*#*#*#***#*#*#*#*#*#*#*#*****#***#*#***#*#*#***#
##*#####*#####*#####*#####*#*#*###*###*#*#*#####*#########*#####*#*#*#####*#*#####*###*#*###*#*#*###
*****#*****#*#***#*******#*#*#***#*#*********#*#***#*#*********#*******#*#*****#*****#***#*********#
##*#####*###*#*#####*#*#######*###*###*###*###*###*#*###*#*#*###*###*###*#*#######*###*#####*###*###
*#***#***********#*#*#*****#*******#***#*#*******#*******#*#***#***#***#*****#*#*****#***#***#*#***#
*#*#########*#*###*###*#*#####*#*#####*#*#####*#####*#######*###*###*###*#####*###*###*#####*#*###*#
***#*#*#*#*#*#*#***#*#*#***#*#*#***#*****#*#*#*****#*#*#*#*#*******#*******#*************#*******#*#
*###*#*#*#*#####*###*###*###*###*#######*#*#*###*#####*#*#*###*#*###*#*#*###*#*#*#*#*#*#######*#####
*#***********#*#*#*********#*********#*********#*****#*******#*#*#*#*#*#*#***#*#*#*#*#*****#***#*#*#
*###*#*###*###*#*###*#*#*#####*#*#*#*###*###*###*#*###*###*#######*#######*#*#########*#*#####*#*#*#
*#***#*#***#*#***#***#*#*#*#*#*#*#*#***#*#*****#*#*******#*****#*#*#*#*****#*#*#*#*#***#***#*******#
*###*#####*#*###*###*#####*#*#######*#######*#####*#*#*###*#*###*#*#*###*#*###*#*#*#####*#*###*###*#
*******#*****#*#*******#*******#*#*******#*#***#*#*#*#*#*#*#***#*********#*#*#*******#*#*#***#*#*#*#
##*#*#######*#*#####*###*###*###*###*#####*#*###*#######*###*###*#*#*#*#*###*#*###*###*###*#####*#*#
***#*#***#*****#*#*********#***#*#*****#*#*****#*********#*****#*#*#*#*#*#*******#***#*#*****#*****#
*#*#####*#####*#*###*#*#*###*###*###*###*#*#####*#####*#####*###*###########*#####*###*###*#####*###
*#*#*******#*****#*#*#*#*#*****#*****#*******#***#*#*#***#*****#*********#***#*#*****#*****#*#*#***#
*#########*#####*#*#######*#*#####*#*###*#####*###*#*#*#####*###*#*#*#*#####*#*###*#####*###*#*#*###
***#*#*#*#***#*******#*#***#*#*****#*#*****#***#*#*****#*******#*#*#*#***#*****#*#*****#*#*********#
*###*#*#*###*#####*###*###*###*#########*#######*#*###*###*#*#########*#######*#*###*#######*###*###
***********#*#*#*****#*#*****#*#*#*#*#*****#*#*#*****#*#***#*#*#*#*#*******#*******#*****#***#*#***#
*#*#*#*#*###*#*###*###*###*#####*#*#*###*###*#*#*#########*###*#*#*###*#*#*#####*#####*#####*#*###*#
*#*#*#*#***#***#***#*#*******#*#*******#***#*****#*#*#*******#*******#*#*#***#***#*#*#*****#*****#*#
########*###*#####*#*#####*###*#*###*###*###*#####*#*###*#*#####*###*#####*#####*#*#*###*#####*###*#
*****#*********#*****#*#*#*********#*******#*#*#*********#*#*#*#*#***#*#*****#*******#*#*****#***#*#
*###*###*#*#*#######*#*#*#######*###*#*#*###*#*###*#*#*#*###*#*#####*#*###*#*###*###*#*###*###*###*#
*#*****#*#*#***#*#*******#*#*#*#*#***#*#*#*********#*#*#*#*******#*****#*#*#***#*#*****#*#*******#*#
*#####*#####*###*###*###*#*#*#*###*#*#########*#*#*#######*###*###*###*#*###*#*#######*#*#####*###*#
***#***#*#*****#***#*#*********#*#*#*#*#*#*#***#*#*#*********#***#*#*******#*#*****#*****#*#*#*#***#
*#*###*#*###*#####*#####*#*###*#*#####*#*#*###*#########*#####*#######*###*###*#########*#*#*###*#*#
*#*#*****#*******#*****#*#*#*****#*#*******#*#*******#*****#*******#***#*******#*#*#*#*#*******#*#*#
*#######*###*#*#####*###########*#*###*###*#*###*#*#####*#####*#*#########*#*###*#*#*#*#####*#####*#
*B*#*#*#*#*#*#***#*********#*#*********#*******#*#***#*#***#*#*#*****#*#***#*#*#*********#***#*#*#*#
##*#*#*#*#*###*#####*###*###*#########*#####*#####*###*#*###*###*#*###*###*###*#*###*#*#####*#*#*###
***********#*******#***#*******#*#*#*#***#***#*#***********#***#*#*******#*#*#*****#*#***#*#*******#
##*###*#*#*###*#*###*###*#######*#*#*###*###*#*###*#*#*#*###*#####*#*#*#####*#*#######*###*#####*###
*#***#*#*#***#*#*******#*#*#*#*#*******#*#*******#*#*#*#*#***#*#*#*#*#***#*******#***********#*#***#
*#*#######*#####*#*#*#####*#*#*#*###*#####*###*#############*#*#*#####*#####*#######*#*#*#*###*#*###
*****#*****#*#*#*#*#*#*#*#*********#***#*#*#*#***#*********#*****#*#*****#***#*#*#*#*#*#*#*********#
*#######*###*#*###*###*#*#*###*#*###*###*###*#*#####*###*#######*#*###*#####*#*#*#*#######*#*#*#*###
*#*#*****#*********#*#*******#*#*#*********#*****#*****#***#*#*#***#*****#***********#***#*#*#*#***#
*#*#####*###*#*#*###*#*###*#######*#*#*#*###*#######*###*###*#*#*#####*#####*#####*#####*#######*#*#
***#*#***#***#*#*#*******#*#*#*#*#*#*#*#*******#*#*#***#*********#*******#***#*#*#***#***#*****#*#*#
##*#*#######*#######*###*###*#*#*#########*#*###*#*#*###*#*#*#######*#*###*###*#*#*#####*#*###*###*#
*******#*********#*#***#*#*********#*#*#*#*#*#*#*******#*#*#***#*****#*#***#*#*******#*#*****#*#***#
*###*#####*#*#*###*#*#######*###*###*#*#*#####*#*###*#####*#######*#*###*###*#*###*###*#*#####*###*#
*#***#*****#*#*#*#*****#*****#***#*******#*#*******#*#*****#*#*****#*#***#*#*****#*#*******#***#***#
*###*###*#*#####*#*###*###*#*###*###*###*#*#####*#####*#*###*###*#*###*###*#*#######*###*###*#####*#
*#*******#***#*#*****#*#***#*#***#***#*****#*#*****#***#*#*******#*#***#*******#*******#*#***#*****#
*###*#*#*#####*#*###*#####*#####*###*#####*#*###*#######*###*#*#*#####*###*#####*###*#####*#*###*#*#
***#*#*#***#*#*****#*#*******#***#*****#*******#*#*#*#*#*#***#*#*#*****#*****#*#***#*#*#***#*#***#*#
*#*#########*#*#####*###*#*#####*###*#######*###*#*#*#*#####*#############*###*#*#####*###*#####*###
*#*******#*#*****#***#***#*#*#***#*******#*****#*********#*******#*#*#*#*****#***#*#*#*****#*******#
##########*#*#####*#####*###*###*###*#*#*###*#####*###*#####*#*###*#*#*###*#####*#*#*#########*#*###
*#*#*#*#*******#***#*********#*#***#*#*#*#*****#***#***#***#*#***********#*#*#*#*****#*#*#*****#*#*#
*#*#*#*###*#####*#####*#*#####*#*#######*###*#########*#*#####*#*#*#*#*###*#*#*#####*#*#*###*#*###*#
*********#***#***#*****#*#*#*********#***#*****#*#*#*#*******#*#*#*#*#***#*******#*******#***#*#***#
*###*#*###*###*#*###*#*###*###*###*#####*###*###*#*#*###*#############*#######*#####*###*###*###*###
***#*#***#***#*#*#***#*#***#*****#*#*#***#***#*********#***#*******#*******#*#***#***#*********#***#
*#####*###*###*#####*###*#####*#####*###*###*###*###*###*#####*###*###*#*###*#*###*#*###*#*#*###*###
***#*****#***#***#*******#*#*#***#*******#*******#*#***#***#***#*****#*#*********#*#*#*#*#*#*#*#*#*#
*###*#*###*###*#####*#####*#*#*#####*#*#*#########*#*###*#####*#####*###*#*#*#*###*###*#######*#*#*#
***#*#*#*****#*#*******#*********#***#*#***#*#*#*#*****#*#*#*****#*****#*#*#*#*#*************#*****#
*###*###*###*#####*#*#####*###*#####*#######*#*#*#*#####*#*###*#####*#############*#*#*#*#*#######*#
***#*******#*#*****#*#*#*#***#*#*********#*#*********#*#*********#***********#*#*#*#*#*#*#*****#*#*#
*#####*#########*#*###*#*#*###*###*#*#*###*#*###*#*###*###*#*#*#*###*###*#####*#*#########*#*###*#*#
*#*#*#***#*#*****#*#*********#*#***#*#*#*#*****#*#*#*#*#***#*#*#*#*#***#***#*************#*#*******#
*#*#*#####*###*#*#####*###*#######*#####*#*#########*#*###*#######*#*###*#####*#*#*#*###*###*#*#*###
*******#*******#*#*#*****#*#*#*******#*******#*#*******#*******#*******#***#***#*#*#*#*****#*#*#***#
*###*#####*#*#*###*###*#####*###*#######*#####*#*###*#*###*#*#*###*#####*#####*###########*#####*#*#
*#***#*****#*#*#*#*#***#*#*******#*#*#*#***#*******#*#***#*#*#*#***#*#*****#*********#*#*******#*#*#
*###*###*#*#####*#*###*#*###*#*###*#*#*#*#####*#######*#######*###*#*###*#*###*#*#*###*###*###*###*#
*#***#***#*#*#*#***#*****#***#*#*#*********#***#*#*#***#*#*****#*******#*#*#*#*#*#*****#*#*#*******#
*###*###*###*#*#*#######*###*###*#*###*#*#####*#*#*#####*###*#*#####*#######*#####*#*###*#####*#*#*#
*#***#*****#*******#*#***#***#**A****#*#*#*#*******#*#*******#*#*#***#*#*#*******#*#*******#*#*#*#*#
*###*###*###*###*###*###*###*###*#*#######*###*###*#*###*#*#*###*###*#*#*###*###*###*#*#*###*#######
*#*************#*****#*********#*#*#***********#*********#*#*****#***********#*******#*#***********#
