*******#***********#
##*###*###*#*###*###
***#*******#*#*****#
*#*###*#*#*#####*###
*#*#*#*#*#***#*#***#
*###*#########*#*###
***#*#*#***#*#*****#
*###*#*#*###*#*#####
***#*****#**A****#*#
*#######*###*#*###*#
*****#*#***#*#*#*#*#
*#*###*###*#####*#*#
*#*******#*********#
##*#*#*###*###*###*#
*#*#*#***#*#*#***#*#
*#####*#####*#*###*#
*#*********#*****#*#
*B##*#*#*###*#####*#
*****#*#*******#***#
####################
