#*********
#*#######*
#*#*#*#***
###*#*###*
#****A**#*
###*#*###*
#***#*#*#*
#*#*B##*#*
#*#*******
##########
