#*#*#*#*#*#*#*#*#*#*
#*#*#*#*#*#*#*#*#*#*
#*******************
#*#*#*#*#*#*#*#*###*
#*#*#*#*#*#*#*#*#***
#*#################*
#*****#*****#*#*#*#*
#*#*#####*###*#*#*#*
#*#*****#*#*********
###*#*###*###*###*#*
#*#*#*****#*#***#*#*
#*###*#####*#*#####*
#*******#*******#***
#*#*#*#####*#######*
#*#*#*#*#*****#*****
#*#####*###*#####*#*
#*****#*#*****#***#*
#*#*###*B##*#####*##
#*#*****#**A**#*****
####################
