#####****#
###A#*##B#
#********#
##*#######
##########
